issue - вопрос, проблема
broad - широкий
broader - шире
broader issues - более широкие вопросы
broadcast - вещание, передача
emit - излучать, испускать, выделять, выбрасывать, выпускать
purgatory - чистилище
circuit - схема
wise - мудрый
wisest - мудрейший
encourage - поощрять
further - в дальнейшем
succeed - добиться успеха
arguably - спорно
implementation - реализация
implement - осуществлять, выполнять, претворять, обеспечивать выполнение, снабжать инструментами; сущ.: орудие, инструмент, принадлежности, принадлежность, фурнитура, прибор
compulsory - принудительная
although - хотя, несмотря на
eliminate - устранить
trickling - сочащийся
trickling down - стекающий
prevalent - превалирующий, распространенный, преобладающий
insight - понимание
demands - требования
demand - спрос, требование
comprehensive - комплексный, всесторонний, исчерпывающий
behave - вести себя
retrieve - извлекать
circumstances - обстоятельства
debunk - развенчивать, разоблачать обман
insurrection - восстание
survey - опрос, обследование, исследование
tub - ванна
torture - пытки
briefcase - портфель
hang - вешать, висеть
hanged - повешенный
hang out - тусоваться, болтаться
cocky - нахальный
highlight - основной момент, световой блик, световой эффект
camcorder - видеокамера
defacement - порча, искажение, обезображивание
spill - проливать, пролить
beaver - бобер
stickler - приверженец, ярый сторонник, упрямый спорщик
caboose - камбуз, служебный вагон, тормозной вагон
cue - кий,сигнал, реплика, намек
coffin - гроб
apparently - по всей видимости, видимо, очевидно
porch - крыльцо, веранда, подъезд
beet - свекла
dove - голубь
mock - издеваться, высмеивать, насмехаться
wuss - слабак
snooty - высокомерный
slip - скользить, проскользнуть, выскользнуть сущ.: скольжение, промах
gutter - водосточный желоб
rivet - заклепка, глаг.: клепать
malfeasance - злодеяние, должностное преступление
vomit - рвота, блевотина, рвотная масса
hussy - потаскушка, нахалка, дерзкая девчонка
festering - гноящийся, гноиться
outrageous - возмутительный, неистовый, вопиющий, скандальный
put out - выводить из себя
gruel - кашица, жидкая каша, размазня
rebound - отскок, рикошет, отдача
betray - предавать
gutsy - бесстрашный
enlighten - просветить
habit - привычка
entice - соблазнять
vapid - бессодержательный
attitude - отношение
bribe - взятка, подкуп
dumpster - мусорный контейнер
sublime - возвышенный
seizure - захват, припадок, приступ
icky - противный, неприятный
phlegm - мокрота, слизь, флегма
mucus - слизь
slime - муть, слизь
snot - сопли
express displeasure - выражать неудовольствие
pacify - усмирять
grow out of something - вырасти из чего-либо
spoil - портить, портиться, баловать
bottle up (feelings) - скрывать, сдерживать, держать в себе
stubborn - упрямый, упорный, неподатливый
throw a tantrum - закатить истерику
willful -  умышленный, преднамеренный, своевольный, своенравный
let (somebody) in - посвятить в дело, раскрыть суть, объяснить
butt of the (joke) - объяснить
mischievous - озорной, вредный, непослушный
prank - шалость, шутка
prevent - предотвращать
brainwash - промывание мозгов
incriminate - инкриминировать, обвинять, изобличать
sleeper agent - шпион в ожидании, «спящий» агент
figure out - выяснить
ruin - разрушать, портить
certain - определенный, некоторый, некий
repeal - аннулировать, отменять.; сущ: отмена, аннулирование
disparaging - пренебрежительный, унизительный
strict - строгий, точный
insult - оскорблять, обижать; сущ: оскорбление, обида
murky - пасмурный, темный, мрачный
peg - колышек
moist - влажный
curiosity - любопытство
pervert - извращенец
chubby - круглолицый, полнощекий
authoring tools - средства разработки
fluke - счастливая случайность
predicament - затруднительное положение
mural - фреска, стенная роспись
stun - ошеломлять
hood - капюшон
accusation - обвинение
yucky - противный
beyond - за, все, после, сверх, свыше
descriptive - описательный, наглядный
significant - значительный, существенный, значимый, важный
muddy - мутный, грязный
spouse - супруг, супруга
funnel - воронка
untraceable - то, что невозможно отследить
evasion - уклонение
cover up - прикрыть, скрывать
make a fuss - суетиться, злиться, поднимать шум, цацкаться
crook - аферист, плут, крюк, посох
neat - аккуратный, опрятный, чистый, изящный
neat (drink) - чистый (напиток), т.е. без льда и сока
savvy - здравый смысл
influential - влиятельный
consciously - сознательно
conscious - сознательный, сознающий, ощущающий, понимающий, здравый, находящийся в сознании; сущ.: сознание
topple - опрокидывать
catch - защемить, поймать; сущ: улов, добыча, выгода, защелка, захват, ловушка
snuggle - прижаться, прильнуть, приютиться, уютно устроиться, свернуться калачиком, прижать, уютно устроить
particularly - особенно, в частности, в особенности
unseasonable - несвоевременный, неуместный, не по сезону
ferocious - свирепый, жестокий, дикий
blizzard - метель, пурга, снежная буря
wash away - смыть, смывать
flood - поток, наводнение, потоп
steady - устойчивый, постоянный, неуклонный
wrack - разрушать, разрушаться; сущ: разрушение, водоросль, остатки кораблекрушения
fluency - плавность, беглость
fluent - беглый, плавный
noticeable - заметный, приметный
spike - шип, колос, острие, костыль
splash - всплеск, плеск, брызги
refer - сослаться, ссылаться, относиться, обращаться
tend - иметь тенденцию
crawl - ползать, ползти, елозить
maintain - поддерживать, сохранять, содержать, обслуживать
tickle - щекотать
dock - пристань, причал
cheer - щека
to spit out - выплюнуть
due - должный
breather - передышка
slip - скольжение, скользить
slip - карточка
endorse - одобрять, поддерживать
update - свежие новости
studs - шпильки
brainstorm - мозговой штурм
propose - предлагать
pitch - высота, подача, наклон, смола, шаг резьбы
damage control - ремонтно-восстановительные работы
shareholder - акционер
stockholder - акционер
debacle - разгром
assassin - убийца
specifically - особенно, конкретно, в частности
apparently - видимо, очевидно
blue laws - пуританские законы
therefore - поэтому, следовательно
participate - участвовать
inflexible - негибкий, непреклонный
neutral - нейтральный
purpose - цель, назначение
to go by (name) - использовать (имя) в повседневной жизни
to take off - стать популярным
instead of - вместо
emphasis - акцент, особое внимание
entire - весь, целый, полный
entirely - полностью, целиком, совершенно, сплошь, всецело, исключительно, в целом, нацело, единственно
line of products - линия продуктов
allure - очарование, обаяние, привлекательность
alluring - заманчивый, соблазнительный, привлекательный, заманчиво, привлекательно
customer base - клиентская база
bricks and mortar store - реальный магазин из кирпичей и раствора, здание магазина
for the rest of the world - в остальном мире
mammoth - гигантский
lizard - ящерица
mine - шахта, рудник
spelunking - спелеология
has to do - имеет отношение к ...
distinction - различие
fast - поститься, голодать
tremendous - огромный
enormous - огромный
needs - нужды, потребности
survive - выживать
boost - ускорять, способствовать росту, повышать, форсировать
intend - намереваться, предназначать, подразумевать, иметь в виду, хотеть, вознамериваться
intent - намерение, цель; прилаг.: пристальный
obstacle - препятствие
overcome - преодолеть
bind - связывать
slick - гладкий, ловкий, скользкий; сущ: пятно, пленка
slack - вялый, слабый, несильный
advantages - преимущества
privilege - привилегия, привилегии, честь, преимущество
controversial - спорный
obviously - очевидно, явно
obvious - очевидный, явный, банальный, ясный, понятный, тривиальный
retina - сетчатка
headquarter - штаб-квартира
emerging - появление
milestone - веха, этап
revenue - доходы, доход
we are willing - мы готовы
eager - нетерпеливый, стремящийся, энергичный, полный страстного желания, острый, горячий, напряженный, сильно желающий
eagerly - с нетерпением, горячо
in-depth - тщательный, всесторонний
meticulous - дотошный, скрупулезный, въедливый, щепетильный
rigorous - строгий, тщательный, точный, скрупулезный, неукоснительный, суровый
proficient - опытный
authoring tools - средства разработки
ongoing - постоянный, непрерывный
moreover - более того, кроме того, сверх того
insight - в поле зрения; сущ: понимание, проницательность, интуиция
buoy - буй
routine - рутина, распорядок, установившаяся практика, шаблон
maintainable - ремонтопригоден
approach - подход, приближение
iterative - итеративный, повторяющийся
decisive - решающее значение
chain - цепь, сеть, цепочка
payroll - начисление заработной платы
payload - полезная нагрузка
devour - пожирать, поглощать, истреблять, лопать
moan - стон; глаг: стонать, жаловаться, охать
gradually - постепенно, понемногу
piecemeal - по частям, постепенно, поштучно
obvious - очевидный, явный
engrossing - захватывающий, увлекательный, всепоглощающий
fundamental - основной, фундаментальный, основополагающий
tenet - догмат, доктрина, постулат
tertiary - третичный
interoperability - совместимость
ranging from - начиная от
ranging - ранжирование, измерение дальности
range - 
vary - изменять, меняться, изменяться, варьировать, менять
range - ассортимент, диапазон, ряд
handful - горсть, handful, пригоршня, горсточка
reckon - рассчитывать, считать
restriction - ограничение
tight - в обтяжку, туго, плотно, крепко, тесно
tighter restrictions - более жесткие ограничения
proposed solution - предложенное решение
worthy - достойный
worth - ценность, достоинства, стоимость
principles - принципы
bareback - неоседланный, без седла, на неоседланной лошади
slap - пощечина, шлепок
spleen - селезенка, сплин, хандра
milt - молоки, селезенка, семенники; глаг.: оплодотворять икру
invaluable - неоценимый, бесценный
replicate - копировать, повторять
booze - выпивка, пьянка, попойка, запой, загул
borrow - заимствовать, занимать
beeswax - пчелиный воск
negotiation - переговоры, согласование
conduct - поведение, ведение; глаг. проводить, вести
scratch - царапина
create from scratch - создать с нуля
nascent - возникающий, появляющийся, рождающийся, зарождающийся
vibrant - вибрирующий
cubicle - кабинка
however - однако
self-deception - самообман
purpose - цель, назначение
impart - передавать, придавать, сообщать, давать
impact - влияние, воздействие, удар, столкновение, импульс, толчок, коллизия; глаг.: ударять, сталкиваться, ударяться
solid understanding - Четкое понимание
solid - твердый, сплошной, прочный, солидный, цельный
assume - предполагать, принимать
regardless - несмотря на
familiarity - знакомство, фамильярность, близкое знакомство, хорошая осведомленность
shorthand - стенография
handy objects - удобный, портативный
tedious - утомительный, нудный, скучный
emitting - излучающий
squawk - пронзительный крик, резкий крик, громкая жалоба, громкий протест
be aware - знать
opinionated - упрямый, самоуверенный, своевольный
ledge - выступ, уступ, планка, край
confidence - уверенность, доверие, вера
multitude - множество, толпа, масса
haystack - стог сена
splendid - великолепный, роскошный, замечательный, превосходный
flagship - флагман
stipulate - оговаривать, обусловливать, ставить условием
tenacity - упорство, цепкость, стойкость, прочность
admire - восхищаться, любоваться, восторгаться
lawsuit - судебный процесс, иск, судебный процесс, тяжба, судебное дело
exhaust - выхлоп, выхлопные газы, выпуск
exhausted - измученный, истощенный, обессиленный
exhaustive - исчерпывающий, истощающий
vet - сущ: ветеринар, ветеран, ветеринарный врач; глаг: проверять, исследовать, лечить, просматривать
perjury - лжесвидетельство, клятвопреступление
loophole - лазейка
coincidental - совпадающий, случайный
bury - похоронить, хоронить, закапывать
ding - звенеть
slimy - слизистый, скользкий
spit - плевать, плюнуть, плеваться, сплюнуть
shabby - потрепанный, потертый, облезлый, поношенный, убогий, жалкий
chase - преследовать, гнаться, выгонять
pry - подглядывать, совать нос, подсматривать
trauma - травма
grindstone - точильный камень, жернов, точило
nub - суть, шишка, утолщение, соль
radiant - лучистый
gimmick - трюк, уловка
mediocrity - посредственность, заурядность
repel - отталкивать, отражать, отгонять
saddle - седло
groan - стон, скрип, треск
clatter - стук, грохот, топот, звон; глаг: цокать, греметь, тарабанить
snort - фырканье
curb - сдерживать; сущ: бордюрный камень, обочина, узда
dice - игральная кость
discard - отбрасывать, выбрасывать, отказываться, сбрасывать
mackerel - скумбрия
chirp - чириканье, щебетание; глаг.: щебетать, чирикать
fidelity - верность, точность, преданность
on-demand - по требованию
make up - составить, компенсировать, составлять, возместить
make up one's mind - надумывать, принимать решение, решать, решаться
make up for - компенсировать
compatibility issues - вопросы совместимости
compatibility - совместимость, сочетаемость
make bold bets - делать смелые ставки
bold - смелый, дерзкий
bolster - поддерживать, подпирать валиком, подстрекать, бросаться подушками
invent - изобретать, придумывать, выдумывать, сочинять
behalf - от имени
probable - вероятный, возможный
rather - скорее, довольно
adverb - наречие
noun - имя существительное
contribute - способствовать, содействовать, делать вклад
endow - наделять
bequeath - завещать
tinker - медник, лудильщик, сапожник, плохой работник, ремонт на скорую руку; глаг: паять, лудить, чинить на скорую руку
tinker with - подправлять
under this company’s umbrella - под эгидой этой компании
gap - разрыв, зазор, пробел, промежуток, щель, отставание
agile - проворный, подвижный, живой, быстрый
agile development - быстрой разработки
essential - существенный, основной, необходимый
elation - восторг, приподнятое настроение, бурная радость, энтузиазм
quotation - цитата, кавычки, котировка
edge - край, преимущество, кромка, ребро, грань, лезвие, острие, окраина, обрез, режущая кромка
it's understood that - понятно, что
surgeon - хирург
spell - заклинание, чары
chin - подбородок
wage - вести, бороться, вести войну сущ: заработная плата, зарплата, возмездие
fairy - фея, волшебница; прилаг.: сказочный,  волшебный
frontier - граница, рубеж
constellation - созвездие
breed - порода, поколение, потомство; сущ: размножаться, разводить, порождать, выводить
tide - волна, поток, течение, прилив
business trip - командировка
jewelry designer - ювелир
fiction - художественная литература, вымысел, фикция, беллетристика
nonfiction - не художественная литература
non-fiction books - научно-популярные книги
farewell - прощайте
regret - сожалеть
out of town - за городом, в отъезде
screen version - экранизация
plot - сюжет, заговор, график
battle scene - батальная сцена
stunt - трюк, эффектное выступление, фокус
safety - страховка, безопасность, сохранность, надежность
revenge - месть, реванш, жажда мести
refuse - отказываться, отказывать, отклонять
look back - оглянуться
look away - отвернуться
look away from - отвести взгляд от
look in - заглянуть
look out - выглядывать, высматривать, быть осторожным
whim - каприз, прихоть, блажь, причуда
sew - шить
mankind - человечество
society - общество, общественность
community - сообщество, община
take up - поднять, занимать, принимать, браться за
take down - опустить, снимать, сносить, записывать
take away - увезти, забрать, отобрать
take in - внести, принимать, брать
take out - вынести, вывезти, брать, вынимать
take over - вступать во владение, перенимать
go up - подниматься
go down - спускаться
go back - возвращаться
go away - уходить прочь, в сторону
go in - заходить, входить
go out - выходить, выходить в свет
rehearse - репетировать
rehearsal - репетиция
contradict - противоречить
contradiction - противоречие
coast - берег, побережье
announcement - объявление, анонс, сообщение, уведомление, извещение
absorb - поглощать, абсорбировать, впитывать
perception - восприятие, ощущение, понимание, осознание
perceive - воспринимать, чувствовать, ощущать, понимать, осознавать, постигать
stuffy - душный, заложенный, спертый, скучный
it's all the same - все равно, все то же самое
consciousness - сознание
subconsciousness - подсознание
voice over - дубляж (в кино), голос за кадром
compatibility - совместимость, сочетаемость
flawless - безупречный
flawlessly - безотказно
mumps - свинка
chicken pox - ветрянка, ветряная оспа
polio - полиомиелит
diphtheria - дифтерия
sore throat - больное горло
swallow - глотать, проглатывать, поглощать; сущ: ласточка, глоток, глотка
hepatitis - гепатит
rubella - краснуха
whooping cough - коклюш, судорожный кашель, захлебывающийся кашель
jeopardize - подвергать опасности, рисковать
opt out - отказаться, уклоняться
sniff - нюхать, вдыхать, чуять, сопеть, фыркать; сущ: сопение, вдох, фырканье, шмыганье носом, хмыканье
primp - прихорашиваться, наряжаться
pooch - дворняжка, собака
briefcase - портфель
ulcer - язва
offence - преступление, правонарушение, нарушение, оскорбление, обида, нападение, проступок
shag - трахать
bail - залог, порука, поручительство, поручитель
booze - выпивка, пьянка, попойка, запой, загул
spree - веселье, загул, пьянка, кутеж
cheer - ура, настроение, радость, веселье, одобрительные возгласы
eke - восполнять
eke out - влачить, восполнять
expenditure - расход, трата
consumption - расход, потребление
spill - пролить, проливать, разливать
bury the hatchet - зарыть топор войны
hatchet - топор, топорик, томагавк
slit - щель, разрез, прорезь
ransom - выкуп, искупление; глаг: выкупать
sincere - искренний, душевный
grovel - пресмыкаться, унижаться
contract a disease - заболеть
mumble - бормотать, заплетаться, бурчать
speak up - высказываться
practically - практически, почти
impaired - ослабленный
earwax - ушная сера
build up - наращивать, строить, укреплять, застраивать
instant - момент, мгновение; прилаг.: немедленный, растворимый
cushion - подушка, борт, диванная подушка
knee - колено
appropriate - присваивать, ассигновать, предназначать; прилаг.: соответствующий, подходящий, уместный
syphon - сифон; глаг.: перекачивать, переливать через сифон
anticipate - предвидеть, ожидать, предвосхищать, опережать, предупреждать
eardrum - барабанная перепонка
decibel - децибел
mitigate - смягчать, уменьшать
run behind - опаздывать, не успевать
make deadline - успеть вовремя
miss the deadline - не успеть вовремя
for what it's worth - за что купил, за то и продаю, то есть не уверен, насколько будет полезна и достоверна информация
advance notice - заблаговременное уведомление
make up for - компенсировать
set back - воспрепятствовать
drag on - тянуться, скучно тянуться, продолжать все то же
awkward spot - неудобная ситуация
awkward situation - неловкое положение, щекотливое положение
awkward - неловкий, неудобный, неуклюжий
clumsy - неуклюжий, неловкий, неповоротливый, топорный
to come to an understanding - прийти к согласию
to do without - обходиться без
dedicated - преданный
committed - идейный, преданный идее
commit - совершать, фиксировать
devoted - посвященный, преданный
messy - грязный, беспорядочный
relief - облегчение
relief valve - предохранительный клапан
relief effort - усилия по оказанию помощи
effort - усилие, попытка
drowsy - сонный, сонливый
slumberous - сонный, навевающий сон
plenty - много, достаточно
gibberish - тарабарщина, неграмотная речь, невнятная речь
lousy - паршивый, мерзкий, отвратительный, вшивый
yuck - гадость, дрянь
shrink - сокращаться, сжиматься, сокращать, уклоняться
booty - добыча, трофеи
resolve - решить, разрешить, устранять, решаться, решиться, разрешиться; сущ: решение, урегулирование, решимость
lynch - линчевать, расправляться самосудом
midget - карлик, лилипут, фитюлька
sufficient - достаточный; сущ: достаточное количество
reconcile - согласовать, примирять, согласовывать, мирить
deprecate - протестовать, выступать против, протестовать, возражать, резко осуждать
depreciation - амортизация, обесценивание, снижение стоимости, умаление
henceforward - впредь, в дальнейшем, с этого времени
hence - следовательно, отсюда
concern - концерн, беспокойство; глаг: касаться, относиться, заботиться, беспокоиться
digest - дайджест, сборник, справочник; глаг: переваривать, усваивать
prophet - пророк
prophetic - пророческий, вещий
drawback - недостаток, препятствие
significant - значительный, существенный, значимый, важный
deplore - сожалеть, оплакивать, порицать
weep - плакать, оплакивать, рыдать
weeny - крохотный, крошечный, маленький
crockery - посуда, фаянсовая посуда, глиняная посуда
gallbladder - желчный пузырь
gallantry - галантность, храбрость, отвага, любовная интрига, ухаживание
brittle - хрупкий, ломкий
fragile - хрупкий
hallmark - отличительный признак, проба, критерий
clarity - ясность, четкость, прозрачность, чистота
hint - намек, совет, оттенок; глаг: намекать
mimic - имитировать, подражать; сущ: имитатор, мим, подражатель; прил: подражательный
screw up - испортить, завинчивать, запороть, задрать
peek - 	быстрый взгляд, взгляд украдкой; глаг: заглядывать
reference - ссылка, справка, упоминание
generic - общий, родовой
recap - резюме; глаг: резюмировать
propose - предложить, предлагать, выдвинуть
blow away - сдувать
cobwebs - хитросплетения
compound - соединение, компаунд, состав, смесь; прил: составной, сложный; глаг: составлять, соединять, смешивать
singular - исключительный, единственный; сущ: единственное число
uncommon - редкий, незаурядный, необыкновенный, замечательный; нареч: необыкновенно, удивительно, замечательно
whack - сильный удар; глаг: делить, колотить, делиться
haze - дымка, туман, мгла
due to - из-за, благодаря
equity - справедливость, беспристрастность, право справедливости, объективность, капитал
well-rounded education - всестороннее образование
behavior - поведение, режим
decouple - расцеплять, разъединять
confess - исповедовать, исповедоваться, признаваться, покаяться, признавать
conformity - соответствие, подчинение
unveil - открывать, раскрывать, снимать покрывало, предстать в истинном свете, торжественно открывать
desecration - осквернение, профанация
acquisition - приобретение, сбор, овладение
reliably - надежно
bootstrap - начальная загрузка
augury - предзнаменование, гадание, предсказание, прорицание, предчувствие
omen - предзнаменование, знак, примета; глаг: предвещать, служить предзнаменованием
versatility - гибкость, многосторонность
twofold - вдвое, вдвойне, вдвое больше; прил: двойной, двукратный, удвоенный
demarcation - разграничение
infamous - позорный, бесчестный, постыдный, пользующийся дурной славой
stutter - заикаться, запинаться; сущ: заикание
soulmate - единомышленник
leverage - система рычагов, действие рычага, рычажная передача, усилие рычага, средство достижения цели, способ для достижения цели
accomplish - выполнять, совершать, достигать
constrain - сдерживать, ограничивать, стеснять, принуждать
breakdown - пробой, распад, разрушение, поломка, распределение, авария, развал, анализ
decay - распад, разрушение, разложение, упадок, гниение, загнивание, тление; глаг: распадаться, разлагаться, разрушаться, гнить
greedy - жадный, алчный
determine - определять
instantiate - иллюстрировать примерами, подтверждать
squeamish - брезгливый, щепетильный, привередливый
fastidious - привередливый, брезгливый, разборчивый, утонченный, изощренный
angular - угловой, угловатый
stump - пень, пенек, обрубок, культя, огрызок, обломок, растушевка; глаг: корчевать, ставить в тупик, выбивать из игры, ковылять, агитировать
I am stumped - я поставлен в тупик, я озадачен
perplex - смущать, ставить в тупик, приводить в недоумение, озадачивать, усложнять, запутывать, сбивать с толку, ошеломлять
dare - дерзать, сметь
nonplus - замешательство, затруднительное положение; глаг: приводить в замешательство, ставить в тупик
boundary - граница, черта, межа; прил: пограничный
glance - взгляд,  беглый взгляд; глаг: взглянуть, глянуть, мельком взглянуть
cohesive - сплоченный, связующий, способный к сцеплению
diverse - разнообразный
vulnerability - уязвимость, ранимость
encourage - поощрять, поддерживать, ободрять, воодушевлять
bundle - пучок, пакет, сверток, узел, связка
intermediate - промежуточный, средний, вспомогательный; сущ: промежуточное звено; глаг: посредничать, вмешиваться
senior - старший
vouch - поручиться, ручаться, подтверждать
unless - если не, пока не; предлог: за исключением, кроме
preference - предпочтение
compliance - согласие, податливость, уступчивость, покладистость, угодливость
atomicity - атомность, валентность
embedded - встроенный
advanced - передовой, продвинутый, прогрессивный, выдвинутый, выдвинутый вперед, повышенного типа, самый современный, успевающий
influence - влияние, воздействие, действие; глаг: оказывать влияние, влиять
conditional - условный
concurrency - совпадение, согласие, согласованность, стечение обстоятельств
reliability - надежность, достоверность, прочность
ease of use - простота использования
scalability - масштабируемость
godly - благочестивый, божественный
implicit - неявный, скрытый, подразумеваемый
explicit - явный, точный, подробный, откровенный, определенный, явно заданный
propagation - распространение, размножение, разведение
along - вдоль, вместе, вперед, с собой, дальше
meanwhile - тем временем, между тем
squad - отряд, команда, отделение, группа, бригада; глаг: сводить в команды, сводить в группы, сводить в отделения
hesitate - стесняться, колебаться, не решаться, призадумываться, запинаться, запнуться
majority - большинство
adulthood - зрелый возраст, зрелость, совершеннолетие
interfere - вмешиваться, мешать, интерферировать, сталкиваться, служить препятствием, мешаться, вредить, быть помехой
likely - вероятно; прил: вероятный, возможный, подходящий, подающий надежды, красивый
get rid of - избавляться от, освобождаться от, отделываться от
qualitatively - качественно
poorly - неудачно, скудно, худо, жалко; прилаг: малолюдный, нездоровый
scantily - скудно
viands - яства, провизия
quirks mode - режим совместимости
quirk - галтель, причуда, бзик, выверт, росчерк пера
quite - довольно, вполне, совсем, совершенно, очень, полностью, действительно, всецело, в самом деле
gaze - взор, пристальный взгляд; глаг: посмотреть, пристально глядеть, пристально смотреть, вглядываться, пялиться
lining - подкладка, выравнивание, футеровка, облицовка, выстилка
ought - должен
speck - пятнышко, частичка, крупинка, шпик, крапинка, крупица, жирное мясо, бекон; глаг: испещрять, пятнать
speckle - пятнать, испещрять; сущ: крапинка, пятнышко
mellow - мягкий, спелый, сочный, зрелый; глаг: созревать
necessity - необходимость
flap - клапан, заслонка, щиток, створка, закрылок; глаг: махать, хлопать, взмахнуть, развеваться
formerly - раньше, прежде
formerly known as - ранее известный как
precisely - именно, точно, в точности, совершенно верно
asterisk - звездочка, знак сноски; глаг: отмечать звездочкой
thorough - тщательный, полный, подробный, основательный, глубокий, доскональный, совершенный, законченный
rare - редкий, редкостный
outrageous - возмутительный, неистовый, вопиющий, скандальный, жестокий, оскорбительный
worth - ценность, достоинства, стоимость, цена, богатство, имущество; прилаг: заслуживающий, обладающий, стоящий
concurrency - совпадение, согласие, согласованность, стечение обстоятельств
purpose - цель, назначение
scope - рамки, сфера, возможности, масштаб, размах, сфера действия, простор, область видимости, границы
neglect - пренебрегать; сущ: пренебрежение, запущенность, безнадзорность, небрежность
handbook - руководство, справочник
swathe - бинтовать, обматывать, перебинтовать, закутывать, пеленать; сущ: повязка, бинт, обмотка
state-of-the-art - самый современный, инновационный
hype - обман, надувательство
applicable - применимый, подходящий, пригодный
numerous - многочисленный, многие, множественный
benefit - пособие, выгода, польза, бенефис, прибыль, пенсия; глаг: извлекать, приносить пользу, помогать
succor - помогать, приходить на помощь, поддерживать; сущ: выручка
nitty-gritty - повседневная работа
synthesize - синтезировать
graduate - выпускник, аспирант, мензурка; глаг: окончить учебное заведение, располагать по порядку, наносить деления, калибровать, сгущать жидкость; прилаг: имеющий ученую степень
clause - пункт, оговорка, предложение, статья, условие, клаузула
rush - прилив, спешка, стремление, ажиотаж, натиск; прилаг: срочный; глаг: торопиться, бросаться, устремляться, торопить, устремиться, мчаться
high-powered - мощный, большой мощности, энергичный, влиятельный, важный
vigorous - энергичный, сильный, ядреный
dozen - дюжина, масса
approach - подход, приближение; глаг: подходить, приближаться
gather - собирать, собираться, почерпнуть, скапливаться, съезжаться; сущ: сбор, урожай
gathering - сбор, встреча, собирание, сборище, скопление
regard - внимание, отношение, уважение; глаг: рассматривать, считать, относиться
remain - оставаться, продержаться, пребывать на прежнем месте, пребывать в прежнем состоянии; сущ: остаток, остальное
grind - молоть, растереть, шлифовать, точить; сущ: размалывание, однообразная работа, зубрежка
whatever - любой, какой бы ни; местоимение: что бы ни, все что, никакой, хоть что-нибудь, какой-либо, какой-нибудь; нареч: все равно
ignorant - невежественный, несведущий, безграмотный, неотесанный, невоспитанный, не знающий о
boorish - невоспитанный, грубый
hobble - хромать, ковылять, прихрамывать, запинаться, спотыкаться; сущ: путы, прихрамывающая походка, заминка, запинка, затруднительное положение, негладкая речь
gain - усиление, прирост, прибыль, увеличение, выигрыш, выгода, доход, выручка, рост, доходы; глаг: получать, набирать
obtain - получать, приобретать, добиваться, достигать, добывать
knowledgeable - хорошо осведомленный, умный
mature - созреть, созревать, взрослеть, вылежаться; сущ: зрелый, выдержанный, развитой, созревший, продуманный, спелый, готовый
elaborate - разрабатывать, вырабатывать, развивать, вдаваться в подробности, тщательно разрабатывать, дополнять; прилаг: сложный, продуманный, детально разработанный, тщательно разработанный
inquiry - запрос, спрос, дознание, справка, расследование, исследование, вопрос, следствие
undertaking - обязательство, предприятие, начинание, дело, соглашение, похоронное бюро, лавка гробовщика; прилаг: предпринимающий
hindsight - непредусмотрительность, взгляд в прошлое, прицел
consider - рассматривать, учитывать, считать, принимать во внимание, полагать
consideration - рассмотрение, внимание, соображение, обсуждение, возмещение, уважение, компенсация, предупредительность
rely - полагаться, надеяться, зависеть
aim - цель, прицеливание, стремление, прицел; глаг: стремиться, целиться, добиваться, прицеливаться, домогаться
overlap - перекрытие, совпадение, нахлестка, покрышка; глаг: перекрывать, частично совпадать, заходить один за другой, частично покрывать
nuzzle - прижаться, тыкаться носом, нюхать, рыть землю рылом, рыться рылом, тереться носом, совать нос, тыкать носом, приютиться, прикорнуть, свернуться в клубок
likewise - также, подобно, более того
prerequisite - предпосылка
interjection - междометие, восклицание
glimpse - проблеск, намек, некоторое представление, мимолетное впечатление, быстрый взгляд, мелькание; глаг: видеть мельком, мелькать, промелькнуть, увидеть мельком
instance - пример, инстанция, образец, экземпляр объекта, отдельный случай, партия, требование, просьба, настояние, партия товара; глаг.: ссылаться, приводить в качестве примера, служить примером
instance of - экземпляр
specimen - образец, экземпляр, проба, образчик, субъект, тип; прилаг.: пробный
fetch - получать, выбирать, привести, приносить, доставать, вызывать, достигать, выручать, добиваться, нравиться; сущ.: двойник, привидение
counterpart - двойник, копия, дубликат, противная сторона, точная копия, что-либо, дополняющее другое
growl - рычание, ворчание, грохот, раскат; глаг.: рычать, ворчать, греметь, жаловаться
drool - нести чепуху, сочиться, течь, распускать слюни, млеть от счастья
occur - происходить, иметь место, встречаться, случаться, являться, попадаться, бывать, приходить на ум
performance - производительность, эффективность, исполнение, выполнение, представление, спектакль, деятельность, характеристика, игра, действие, эксплуатационные качества, летные качества
perform - выполнять, совершать, исполнять, выступать, играть, проделать, представлять, исполнять роль, делать трюки
sequential - последовательный, являющийся продолжением, являющийся следствием
bother - беспокоить, беспокоиться, надоедать, докучать, волноваться, побеспокоить, хлопотать, суетиться, тормошить; сущ.: беспокойство, хлопоты, источник беспокойства, надоедливый человек
guidelines - методические рекомендации
guideline - директива, установка, руководящие указания, руководящее указание, общий курс, генеральная линия
tortuous - извилистый, неискренний, уклончивый
undulating - волнообразный, волнистый
corrugated - гофрированный, рифленый, волнистый, сморщенный
mottled - пестрый, крапчатый, испещренный, половинчатый
hoodie - толстовка с капюшоном, серая ворона
rusty - ржавый, заржавленный, заржавевший, хриплый, порыжевший, цвета ржавчины, покрытый ржавчиной, сердитый, норовистый, устаревший, запущенный, прогорклый, злой, раздражительный; глаг.: всколыхнуть
groove - паз, канавка, желобок, борозда, выемка, ручей, прорез, нарез, привычка, калибр, выбоина, рутина
groovy - захватывающий, волнующий
whether - будь то, ли; местоимение: который
unify - унифицировать, объединять
codify - кодифицировать, шифровать, приводить в систему, составлять кодекс
regarding - о, относительно, касательно
snail - улитка, тихоход, спираль, копуша
slate - шифер, список кандидатов, грифельная доска, аспидный сланец, шиферный сланец, аспид, шиферная плита; глаг.: намечать, крыть шиферными плитами, заносить в список кандидатов, делать выговор, раскритиковать
eventually - в конечном счете, в конце концов, со временем
e.g. - например
reveal - раскрывать, открывать, показывать, обнаруживать, вскрывать, разоблачать; сущ.: откровение, разоблачение, четверть, притолока
complain - жаловаться, пожаловаться, сетовать, выражать недовольство, поплакаться, ныть, подавать жалобу
custom - обычай, привычка, заказы, пошлина, клиентура, обычное право, покупатели, таможенные пошлины, таможенное управление; прилаг.: изготовленный на заказ, сделанный на заказ
laborious - трудоемкий, трудный, трудолюбивый, тяжелый, многотрудный, утомительный, вымученный, усердный, старательный
ludicrous - смехотворный, смешной, нелепый
indecisive - нерешительный, неокончательный, колеблющийся, нерешающий, неопределенный
mount - монтировать, устанавливать, восходить, садиться на лошадь, расти; сущ.: гора, оправа, холм, паспарту, подложка, бугорок, восхождение
insanely - безумно
poach - вмешиваться, браконьерствовать, незаконно охотиться, вторгаться, присваивать, подстрекать, вторгаться в чужие владения, размешивать, захватывать не по правилам, тяжело ступать, разрывать копытами, делаться изрытым
curly braces - фигурные скобки
evaluate - оценивать, иметь значение, определять качество, определять количество, выражать в цифрах, выражать в числах
blissful - блаженный, счастливый
bliss - блаженство, счастье, нега
indistinguishable - неразличимый
distinguishable - различимый, отличимый
distinguish - различать, отличать, выделить, распознавать, проводить различие, выделять, разглядеть, отмечать, видеть различие, характеризовать, служить отличительным признаком; прилаг.: значительный
linger - задерживаться, медлить, засиживаться, замешкаться, влачить существование, затягиваться, тянуться, мешкать, опаздывать, медленно умирать, терять время даром
commitment - обязательство, совершение, передача, вручение, заключение под стражу, арест, передача законопроекта в комиссию, загруженность
accessibility - доступность, общедоступность, удобство подхода, легкость осмотра, легкость ремонта
fully live up - полностью оправдал
inexact - неточный
custard - заварной крем, крем, сладкий крем
premature - преждевременный, поспешный, непродуманный
jagged - зубчатый, зазубренный, неровно оторванный, пьяный
overwhelmed - перегружен; прилаг.: потрясенный, ошеломленный
overwhelm - подавлять, сокрушать, заваливать, ошеломлять, забрасывать, обуревать, овладевать, переполнять, заливать, разорять, разбивать, потрясать, затоплять, губить, поражать
granted - предоставленный; нареч.: разрешено, позволено, ладно; союз: при условии
evocation - воскрешение в памяти, вызывание духов
macaroon - миндальное печенье
parlor - кабинет, зал, гостиная, приемная, ателье, отдельный кабинет, общая комната
evaporate - испаряться, испарять, выпаривать, улетучиваться, исчезать, сгущать, умирать, умереть
sustainable - устойчивый, поддерживаемый
sustain - поддерживать, выдерживать, подкреплять, испытывать, выносить, доказывать, подтверждать, подпирать
chevy - охота, погоня, охотничий крик; глаг.: гнаться, удирать
disturbing footage - тревожные кадры
disturbing - беспокоящий, волнующий, беспокойный
mutilation - увечье, искажение
justify - оправдывать, объяснять, подтверждать, выравнивать, находить оправдание, извинять, выключить строку
moult - линька; глаг.: линять
molt - линька; глаг.: линять
shed - сарай, навес, депо, ангар; глаг.: пролить, проливать, лить, терять, сбрасывать, распространять, излучать; прилаг.: пролитый
stitch - стежка, стежок, шов, петля, малость, немножко, острая боль в боку; глаг.: шить, вышивать, строчить, тачать, сброшюровать
fur - мех, шерсть, налет, пушнина, шкура, налет на языке, меховые изделия, осадок, накипь, пушной зверь; прилаг.: меховой, пушной
consistent - последовательный, совместимый, согласующийся, стойкий, плотный, твердый
consist - состоять, заключаться в, совпадать, совмещаться; сущ.: состав
consistency - последовательность, согласованность, консистенция, постоянство, логичность, плотность, состав, степень густоты, степень плотности
predicate - предикат, сказуемое, утверждение; прилаг.: предикативный; глаг.: утверждать, основывать на фактах
coerce - принуждать, заставлять, сдерживать, удерживать, сообщить движение
distinguish - различать, отличать, выделить, распознавать, проводить различие, выделять, разглядеть, отмечать, видеть различие, характеризовать, служить отличительным признаком; прилаг.: значительный
mundane - мирской, земной, светский
worldly - мирской, земной, светский, житейский, искушенный, опытный, любящий жизненные блага
latency - латентность, задержка, скрытое состояние
knit - вязать, объединяться, связывать, соединять, скреплять, сращивать, соединяться, скрепляться, сращиваться, срастаться; сущ.: трикотаж, вязка, трикотажное изделие
cowardly - трусливый, малодушный; нареч.: трусливо
sneaky - подлый, трусливый
sneak - красться, стащить, делать украдкой, делать тайком, ябедничать, фискалить, доносить, украсть; сущ.: ябеда, подлец, воришка, доносчик
dairy free - без молока
dairy - молочная, молочный, маслодельня, молочная ферма, сыроварня; прилаг.: молочный
diary - дневник, записная книжка, записная книжка-календарь
treat - удовольствие, угощение; глаг.: лечить, относиться, обращаться, обрабатывать, трактовать, угощать, обходиться, полечить, вести переговоры, иметь дело
merely - просто, только, единственно
slender - тонкий, стройный, худенький, небольшой, субтильный, слабый, незначительный, скудный, грациозный
rather - скорее, довольно, вернее, лучше, несколько, предпочтительнее, слегка, охотнее, до некоторой степени, правильнее, пожалуй, конечно, да
boredom - скука
pursue - преследовать, продолжать, заниматься, гнаться за, следовать по намеченному пути, бежать за, предъявлять иск, следовать неотступно за, действовать по плану, иметь профессию, предъявлять обвинение, вести следствие
scatter - разброс, рассеивание; глаг.: рассеивать, рассеять, разбрасывать, раскидывать, разбросать, рассеиваться, посыпать, закидать, разбегаться, рассыпать
pursuit - преследование, стремление, погоня, гонка преследования, поиски, занятие
slop - помои, слякоть, жидкая пища, спецовка, полицейский, жидкая грязь, дешевая готовая одежда; глаг.: расплескивать, проливать, проливаться, хлюпать, расплескиваться
fetch - получать, выбирать, привести, приносить, доставать, вызывать, достигать, выручать, добиваться, нравиться; сущ.: двойник, привидение
trade-off - компромисс, взаимные уступки
trade-off - компромисс, взаимные уступки
give-and-take - взаимные уступки, компромисс, обмен мнениями, обмен любезностями
fallback - отступление, резерв, выпадение
composition - состав, композиция, структура, смесь, сочинение, составление, произведение, соединение, набор, компоновка, построение; прилаг.: композиционный
vulnerability - уязвимость, ранимость
immature - незрелый, молодой, неспелый, несозревший, юный, недоразвившийся, недостаточно развитый, преждевременный
mature - созреть, созревать, взрослеть, вылежаться; прилаг.: зрелый, выдержанный, развитой, созревший, продуманный, спелый, готовый, выношенный
rhinoceros - носорог
snapshot - снимок, фотография, фотокарточка, выстрел, выстрел навскидку; глаг.: делать снимок, фотографировать
woefully - горестно, удручающе, прискорбно, скорбно
woe - горе, скорбь, несчастье, проблемы, головная боль
woesome - несчастный, скорбный, горестный, жалкий, страшный, очень плохой
inadequate - недостаточный, неадекватный, неполноценный, не отвечающий требованиям, несоразмерный, неуважительный
spurt - рывок, бросок, приступ, вспышка, внезапное резкое усилие, взрыв чувства, сильная струя; глаг.: бить струей, делать рывок, делать внезапное усилие, хлынуть, выбрасывать струей
evenly - равномерно, ровно, поровну, спокойно, одинаково, справедливо, беспристрастно, уравновешенно
tout - рекламировать, шпионить, зазывать, расхваливать, навязывать товар, агитировать за кандидата; сущ.: навязывающий свой товар, коммивояжер, жучок, человек, зазывающий клиентов
boilerplate - шаблонный
bound - связанный, направляющийся, переплетенный, ограниченный, обязанный, в переплете; сущ.: граница, предел, ограничение, прыжок, скачок; глаг.: связывать
retrieve - извлекать, вернуть, восстанавливать, возвращать в прежнее состояние
exonerate - реабилитировать, оправдывать, снимать бремя; прилаг.: оправданный, реабилитированный
gear - механизм, шестерня, передача, принадлежности, снасти, зубчатое колесо, привод, зубчатая передача, аппарат, передаточный механизм, приспособления, одежда
adamant - непреклонный, твердый, несокрушимый, несгибаемый; сущ.: адамант, алмаз, твердый минерал, бриллиант, твердый металл, что-либо несокрушимое, что-либо твердое
unaware - не подозревающий, не знающий о, невосприимчивый
digestion - пищеварение, усвоение, усвоение пищи, понимание
digest - дайджест, сборник, справочник, краткое изложение, резюме, компендиум, краткий сборник решений суда; глаг.: переваривать, усваивать, вываривать, классифицировать, приготовлять компост
conventional - обычный, традиционный, условный, стандартный, общепринятый, обусловленный, светский
undigested - неусвоенный, непереваренный, непродуманный, непоследовательный, хаотичный
bloat - раздуваться, пухнуть, коптить; сущ.: утопленник, пьяница
due to - из-за
due to the fact - в связи с тем
due to the lack - из-за отсутствия
lack - отсутствие, недостаток
claim - требовать, претендовать, утверждать; сущ.: требование, иск, претензия, утверждение, заявление, заявка, жалоба, притязание, рекламация
excessive - чрезмерный, излишний, безмерный; сущ.: эксцессив, чрезмерная степень
gut - кишка, пищеварительный канал, кетгут, узкий пролив, узкий проход, струна или леса из кишки; глаг.: потрошить, опустошать, есть с жадностью; прилаг.: инстинктивный, насущный, слепой
distend - раздувать, надуваться, растягивать, раздуваться, вспучиваться, вспучивать, надувать
hop - прыгать, подпрыгивать, перепрыгивать, вскакивать, прыгать на одной ноге, танцевать; сущ.: хмель, перелет, прыжок, скачок, танцы, полет
distress - бедствие, горе, страдание, несчастье, беда, недомогание, нужда, боль, нищета, истощение, утомление; глаг.: огорчать
hemp - конопля, пенька, гашиш, марихуана, веревка
shelf - полка, шельф, отмель, выступ, уступ, риф, мель
vast - огромный, обширный, громадный, безбрежный, многочисленный; сущ.: простор
vast majority - подавляющее большинство
pesky - докучливый, досадный, надоедливый
hoof - копыто, нога, копытное животное; глаг.: увольнять, выгонять, бить копытом
nefarious - гнусный, низкий, нечестивый, бесчестный, скверный
potent - мощный, сильный, сильнодействующий, могущественный, крепкий, убедительный, обладающий потенцией
dense - плотный, густой, дремучий, тупой, компактный, частый, глупый, непрозрачный, недогадливый
by-product - побочный продукт
deem - считать, полагать, думать, размышлять
fabulous - невероятный, потрясающий, легендарный, баснословный, мифический, неправдоподобный, преувеличенный
privy - тайный, посвященный, конфиденциальный, частный, скрытый, уединенный, сокровенный; сущ.: уборная, туалет, заинтересованное лицо
filler - наполнитель, шпатлевка, воронка, заряд, наливное отверстие, тот, кто заполняет
jack up - бросать, поднимать домкратом, оставлять
urge - побуждение, импульс, толчок, сильное желание; глаг.: убеждать, побуждать, настаивать на, подгонять, понуждать, подстрекать, настоятельно советовать, нукать, надоедать, твердить одно и то же
retain - удерживать, сохранять, хранить, поддерживать, помнить, приглашать
hull - корпус, остов, каркас, фюзеляж, шелуха, скорлупа; глаг.: шелушить, лущить, очищать от шелухи
insoluble - нерастворимый, неразрешимый
defatted - обезжиренный
fine - штраф; глаг.: оштрафовать, штрафовать; нареч.: хорошо, прекрасно, отлично, превосходно; прилаг.: прекрасный, мелкий, тонкий, хороший, превосходный
additive - добавка, присадка, примесь
ingest - глотать , проглатывать, усваивать, впитывать
intake - потребление, впуск, поглощение, всасывание; прилаг.: впускной, всасывающий
mope - хандрить, киснуть, быть ко всему безучастным, быть в подавленном состоянии; сущ.: угрюмый человек, хандра
gather - собирать, собираться, почерпнуть, скапливаться, съезжаться, приобретать, снимать, рвать, стягиваться; сущ.: сбор, урожай
gathering - сбор, встреча, собирание, сборище, скопление, уборка, собрание людей, комплектование, уборочный сезон, нарыв, гнойник, нагноение; прилаг.: собирающий
fatigue - усталость, утомление, утомительная работа, утомительность, рабочая команда, нестроевой наряд; глаг.: утомлять, изнурять
augury - предзнаменование, гадание, предсказание, прорицание, предчувствие
snippet - отрывок, кусок, отрезок, обрезок, лоскут
ember - тлеющие угли, последние красные угольки, горячая зола
embers - угольки, еще не погасшие угольки, еще не угасшие чувства
coal - уголь, каменный уголь, уголек; прилаг.: каменноугольный; глаг.: грузиться углем, обугливаться, грузить углем
embarrass - смущать, стеснять, конфузить, затруднять, обременять, приводить в замешательство, запутывать
embarrassing - смущающий, затруднительный
ubiquitous - вездесущий, повсеместный, встречающийся повсюду
encompass - заключать в себе, окружать, обносить стеной
ambient - окружающий, обтекающий, охватывающий; сущ.: внешняя среда
torch - факел, горелка, светоч, паяльная лампа, карманный фонарик, переносной фонарь; глаг.: освещать факелами
disavow - дезавуировать, отрицать, отмежеваться, отрекаться, отказываться, отпираться, не признаваться, снимать с себя ответственность, отнекиваться
renounce - отказываться, отрекаться, отвергать, не признавать, отрешаться, отклонять, делать ренонс; сущ.: отречение, ренонс
disclaim - отрицать, отказываться, отрекаться, не признавать
disclaimer - отказ, отречение
renouncement - отказ, отречение
wire - провод, проволока, телеграмма, телеграф; глаг.: телеграфировать, монтировать провода, скреплять проволокой, связывать проволокой, устанавливать провода, монтировать, ловить в проволочные силки; прилаг.: проволочный
corroborate - подтверждать, подкреплять
moderate - умеренный, средний, небольшой, сдержанный, невысокий, посредственный, выдержанный, воздержанный; глаг.: умерять, смягчать, сдерживать, выступать в роли арбитра
crash course - ускоренный курс, опасный курс
tie - галстук, связь, ничья, завязка; глаг.: связать, завязать, связывать, завязывать, привязывать, увязать, повязать, завязываться
acme - вершина, высшая точка, кульминация, кризис, кульминационный пункт
revelation - откровение, открытие, раскрытие, разоблачение, богооткровение
revealing clothes - откровенная одежда
specific - конкретный, определенный, специфический, удельный, особый
sufficient - достаточный; сущ.: достаточное количество
youth - молодежь, молодость, юность, юноша, молодняк; прилаг.: молодежный
blemish - пятно, недостаток, позор; глаг.: портить, вредить, пятнать, позорить
insist - настаивать, настоять, утверждать
rush off - бежать (внезапно)
pathetic - жалкий, патетический, трогательный
mope - хандрить, киснуть, быть ко всему безучастным, быть в подавленном состоянии; сущ.: угрюмый человек, хандра
pawn shop - ломбард
raise money - собирать деньги, добывать деньги
raise - повышение, подъем, увеличение; глаг.: поднимать, повышать, воспитывать, растить, ставить, вызывать
hock - заклад, поджилки, клюка, коленное сухожилие, посох; глаг.: закладывать
tide over - преодолевать
legitimate - законный
pawnbroker - ростовщик
collateral - побочный, косвенный, боковой, второстепенный, параллельный, добавочный; сущ.: обеспечение, дополнительное обеспечение, родственник по боковой линии
fraction - фракция, доля, часть, дробь
redeem - выкупать, искупать, избавлять, спасать, возвращать, освобождать, выплачивать, исправлять, возмещать, выполнять
forfeit - штраф, неустойка, фант, расплата, конфискация, потеря, конфискованная вещь, игра в фанты; глаг.: поплатиться, лишаться, терять право; прилаг.: штрафной, конфискованный
recoup - компенсировать, отыгрываться, возмещать
complain - жаловаться, пожаловаться, сетовать
massacre - резня, бойня, избиение; глаг.: устраивать резню
retire - выходить на пенсию, уходить, удаляться, уходить в отставку, увольняться, отступать
take over - вступать во владение, перенимать, принимать должность, принимать от другого
prohibition - запрет, запрещение, сухой закон
rival - соперничать, конкурировать; сущ.: соперник, конкурент, противник; прилаг.: конкурирующий, соперничающий
raid - рейд, набег, налет, облава,  внезапное нападение; глаг.: совершать налет, совершать набег, совершать облаву
bedding - постельные принадлежности
overlapping - дублирование, перекрытие, параллелизм, повторение; прилаг.: параллельный, частично дублирующий
outspoken - откровенный, прямой, искренний
atone - искупить, искупать, компенсировать, заглаживать, возмещать
make amends - делать поправки, загладить вину
penance - покаяние, наказание, епитимья, раскаяние, искупление, кара, показание; глаг.: налагать епитимью
compassion - сострадание, сочувствие, жалость; глаг.: сочувствовать
empathy - сочувствие, сопереживание
hint - намек, совет, оттенок, налет; глаг.: намекать
tuition fee - плата за обучение
tuition - обучение
loan - заем, ссуда, заимствование; прилаг.: ссудный; глаг.: давать взаймы, ссужать
consecutive - последовательный
streak - полоса, полоска, жилка, прожилка, прожилок, струя, прослойка, прослоек, период; глаг.: испещрять, мелькать, прочерчивать
revamp - починить, поправлять, переделать, ремонтировать, ставить новую союзку
redundant - лишний, излишний, чрезмерный, многословный, уволенный по сокращению штатов; сущ.: резервный элемент, система с резервированием
achievement - достижение, успех, выполнение, подвиг
rainfall - количество осадков, ливень
variance - расхождение, изменение, несоответствие, дисперсия, разногласие, отклонение от вида, размолвка, отклонение от типа
assert - утверждать, отстаивать, заявлять, защищать, доказывать, предъявлять обвинение
honor - честь, слава, почет, почести, почтение, уважение; глаг.: почтить, чтить, соблюдать, выполнять, почитать, уважать
firmware - прошивка
vendor - продавец, торговец, торговый автомат
grasshopper - кузнечик, саранча, легкий связной самолет
beam - луч, балка, брус, ширина, бревно, коромысло, перекладина, пучок лучей, балансир, бимс, траверз; глаг.: излучать
evenly - равномерно, ровно, поровну, спокойно, одинаково, справедливо, беспристрастно, уравновешенно
cuckoo - кукушка, разиня, кукование, глупец; глаг.: куковать; прилаг.: спятивший, чокнутый, не в своем уме, шизанутый, помешанный
vague - неопределенный, расплывчатый, неясный, смутный, рассеянный, неуловимый, отсутствующий
parentheses - круглые скобки
allegiance - верность, преданность, лояльность, верноподданство, вассальная зависимость
coincidence - совпадение, случайное стечение обстоятельств
wage - вести, бороться, вести войну, проводить, платить жалование; сущ.: заработная плата, зарплата, возмездие; прилаг.: связанный с заработной платой
glitch - авария, внезапный отказ, неожиданная поломка, сбой
marvelous - чудесный, чудный, изумительный, замечательный, удивительный, дивный, необыкновенный; сущ.: чудесное, удивительное, непостижимое
scurvy - цинга; прилаг.: подлый, презренный, низкий
haw - боярышник, ограда, бормотание, ягода боярышника
hawk - ястреб, сокол, хищник, хищная птица; прилаг.: ястребиный; глаг.: налетать как ястреб, охотиться с соколом, охотиться с ястребом, откашливать, отхаркивать, отхаркиваться, откашливаться
bias - смещение, предвзятость, уклон, предубеждение, необъективность, тенденциозность
grater - терка, рашпиль
rasp - скрежет, рашпиль, терка, терпуг, дребезжание, напильник, скребущий звук, досада; глаг.: строгать, подпиливать, скрести, раздражать
pageantry - великолепие, шик, пышное зрелище, блеск, помпа, пустая видимость, фикция, блеф
rumor - слух, молва, толки; глаг.: распространять слухи, рассказывать новости
shallow - мелкий, мелководный, поверхностный, пустой, маловодный; сущ.: мелководье, отмель, мель, мелкое место; глаг.: мелеть, уменьшать глубину
swanky - шикарный, модный, щегольской; сущ.: щеголь
dignity - достоинство, сан, благородство, титул, звание, лица высокого звания, знать
crave - жаждать, страстно желать, требовать, просить, умолять
vowel - гласный; сущ.: гласный звук
consonant - согласный, созвучный, совместимый, гармоничный; сущ.: согласный звук
tenure - срок пребывания, пребывание, владение, пребывание в должности, срок владения, недвижимость
vague - неопределенный, расплывчатый, неясный, смутный, рассеянный, неуловимый, отсутствующий
precede - предшествовать
inkling - намек, догадка, слабое представление, слабое подозрение
orphan - сирота; прилаг.: сиротский; глаг.: делать сиротой, лишать родителей
ruse - хитрость, уловка
loiter - мешкать, слоняться без дела, медлить, копаться, валандаться, отставать
omit - пропускать, не включать, упускать, пренебрегать
inefficient - неэффективный, неумелый, непроизводительный, безрезультатный, неспособный, плохо действующий
slacks - широкие брюки
lurk - таиться, скрываться, прятаться, скрываться в засаде, оставаться незамеченным; сущ.: обман
pleasant - приятный, милый, славный, отрадный, веселый, шутливый
variegated - разнообразный, пестрый, разноцветный, неоднородный, разнохарактерный, смешанный, разносторонний
variegate - разнообразить, делать пестрым, раскрашивать в разные цвета
interrelated - взаимосвязаны
rake - грабли, повеса, скребок, распутник, скос, развратник, наклон, передний угол, кочерга; глаг.: разгребать, загребать, сгребать
deceive - обманывать, вводить в заблуждение, изменять, сбивать с толку, нарушать верность
eavesdropping - подслушивание
devise - разрабатывать, изобретать, придумывать, завещать, задумывать; сущ.: завещание, завещанное имущество
exclamation - восклицание
gritty - песчаный, твердый, с песком, смелый
petal - лепесток
cipher - шифр, нуль, ноль, ничтожество, арабская цифра, монограмма; глаг.: шифровать, зашифровывать, вычислять, высчитывать
keen - острый, проницательный, сильный, тонкий, сильно желающий, глубокий
apron - фартук, передник
ambiguity - двусмысленность, неопределенность, неясность
sprout - росток, побег, отросток, брюссельская капуста; глаг.: прорастать
admit - признавать, допускать, принимать, впустить
daunt - обескураживать, запугивать, устрашать
concise - краткий, сжатый, четкий, сокращенный, выразительный, немногословный
strain - штамм, напряжение, деформация, нагрузка, сорт, растяжение, натяжение, порода, мелодия; глаг.: напрягать, напрягаться, процедить
assert - утверждать, отстаивать, заявлять, защищать, доказывать, предъявлять обвинение
thrive - процветать, преуспевать, разрастаться, буйно разрастаться, буйно расти, пышно расти, пышно разрастаться
unanimously - единогласно
faction - фракция, группировка, клика, раздоры, дух интриги
nudge - легкий толчок локтем; глаг.: слегка подталкивать локтем
negate - отрицать, отвергать, сводить на нет, опровергать, делать недействительным
hurdle - препятствие, барьер, плетень, перегородка, затруднение
questionnaire - вопросник, анкета
contentious - спорный, сварливый, вздорный, придирчивый, любящий спорить
tug-of-war - перетягивание каната, решающая схватка, решительная борьба
grumble - ворчать, жаловаться, брюзжать, бурчать, разворчаться, греметь, грохотать; сущ.: ропот, ворчание, грохот, воркотня, дурное настроение, гром
abstain - воздерживаться, не принимать участия
captive - пленник, пленный; прилаг.: пленный, взятый в плен
proposal - предложение, заявка, план
onward - вперед, далее, дальше, впереди; прилаг.: прогрессивный, движущийся вперед, идущий вперед, продвигающийся
slight - легкий, незначительный, слабый, худощавый, тонкий, хрупкий, изящный; сущ.: пренебрежение, неуважение, игнорирование; глаг.: пренебрегать, третировать, относиться небрежно
withdraw - изымать, отзывать, уходить, забирать, увести, удаляться, ретироваться, извлекать, отводить, отвыкать, отдергивать, брать назад
abandon - отказываться от, оставлять, покидать, бросать, предаваться; сущ.: развязность, несдержанность, непринужденность
bleed over into - перенесётся
narrow - узкий
convince - убеждать, уверять, доводить до сознания
bandwagon - грузовик с оркестром, победившая сторона, повальное увлечение, фургон с оркестром, массовое движение, сторона, одержавшая победу
so far so good - пока все хорошо, пока все в порядке
fledge - оперять, оперяться, выкармливать птенцов, выстилать пухом и перьями
dealt with - иметь дело с
nerd - умник, лох, болван, тупица
overhaul - ремонт, капитальный ремонт, пересмотр, тщательный осмотр, капремонт; глаг.: перестраивать, тщательно осматривать, разбирать, ремонтировать, капитально ремонтировать, реконструировать, догонять
level off - выровнять, выравнивать, делать ровным, выравнивать самолет
elucidate - освещать, разъяснять, объяснять, проливать свет
gullible - легковерный, доверчивый
downsides - отрицательные стороны
impatient - нетерпеливый
alumnus - выпускник, бывший питомец
alumni - выпускники
forecast - прогноз, предсказание; глаг.: прогнозировать, предсказывать, предвидеть
pledge - залог, обещание, обет, заклад, зарок, поручительство, подарок; глаг.: закладывать, отдавать в залог, обещать, заверять, пить за здоровье
grasp - понять, осознать, схватывать, усвоить, хвататься, захватывать, постигать; сущ.: понимание, схватывание, хватка, власть, контроль
handicap - препятствие, помеха, увечье
clause - пункт, оговорка, предложение, статья, условие